#######       #######
#__%__#       #######
#_____#       #######
#_____#       #######
#_____#       #######
#_____#       #######
###_###       #_____#
###_###########_____#
#_____##_____##_____#
#_____##_____##_____#
#________________@__#
#_____##_____##_____#
#_____##_____##_____#
###_#############_###